#;Código DIVIPOLA;DEPARTMENT;Municipality;TOTAL;Urban Area ;Rural Area
1;5001;Antioquia;Medellín;2427129;2382399;44730
2;5002;Antioquia;Abejorral;20367;7674;12693
3;5004;Antioquia;Abriaquí;2695;824;1871
4;5021;Antioquia;Alejandría;4657;2485;2172
5;5030;Antioquia;Amagá;30227;14184;16043
6;5031;Antioquia;Amalfi;25962;14508;11454
7;5034;Antioquia;Andes;43269;20250;23019
8;5036;Antioquia;Angelópolis;5756;2168;3588
9;5038;Antioquia;Angostura;11437;2628;8809
10;5040;Antioquia;Anorí;18321;7634;10687
11;5042;Antioquia;Santafé de Antioquia;26164;16351;9813
12;5044;Antioquia;Anza;7010;1258;5752
13;5045;Antioquia;Apartadó;121003;98454;22549
14;5051;Antioquia;Arboletes;29295;9747;19548
15;5055;Antioquia;Argelia;7689;3412;4277
16;5059;Antioquia;Armenia;5139;1716;3423
17;5079;Antioquia;Barbosa;51969;22174;29795
18;5086;Antioquia;Belmira;6000;1623;4377
19;5088;Antioquia;Bello;522264;495483;26781
20;5091;Antioquia;Betania;10323;3601;6722
21;5093;Antioquia;Betulia;15607;4274;11333
22;5101;Antioquia;Ciudad Bolívar;26118;15604;10514
23;5107;Antioquia;Briceño;8039;2552;5487
24;5113;Antioquia;Buriticá;9354;2235;7119
25;5120;Antioquia;Cáceres;28996;5355;23641
26;5125;Antioquia;Caicedo;8297;1657;6640
27;5129;Antioquia;Caldas;79638;62987;16651
28;5134;Antioquia;Campamento;9203;2466;6737
29;5138;Antioquia;Cañasgordas;15523;5076;10447
30;5142;Antioquia;Caracolí;4582;2739;1843
31;5145;Antioquia;Caramanta;4743;2190;2553
32;5147;Antioquia;Carepa;47932;33009;14923
33;5148;Antioquia;El Carmen de Viboral;59416;34187;25229
34;5150;Antioquia;Carolina;3954;2929;1025
35;5154;Antioquia;Caucasia;90213;76772;13441
36;5172;Antioquia;Chigorodó;57375;47046;10329
37;5190;Antioquia;Cisneros;9775;8415;1360
38;5197;Antioquia;Cocorná;15444;6293;9151
39;5206;Antioquia;Concepción;4797;1908;2889
40;5209;Antioquia;Concordia;21377;7349;14028
41;5212;Antioquia;Copacabana;77884;62343;15541
42;5234;Antioquia;Dabeiba;23044;9042;14002
43;5237;Antioquia;Don Matías;18902;12081;6821
44;5240;Antioquia;Ebéjico;12158;2229;9929
45;5250;Antioquia;El Bagre;51862;32823;19039
46;5264;Antioquia;Entrerrios;11159;5643;5516
47;5266;Antioquia;Envigado;228848;215766;13082
48;5282;Antioquia;Fredonia;24408;8031;16377
49;5284;Antioquia;Frontino;20739;8639;12100
50;5306;Antioquia;Giraldo;5544;2061;3483
51;5308;Antioquia;Girardota;51662;28652;23010
52;5310;Antioquia;Gómez Plata;9753;5017;4736
53;5313;Antioquia;Granada;10117;5541;4576
54;5315;Antioquia;Guadalupe;6560;2223;4337
55;5318;Antioquia;Guarne;55121;18342;36779
56;5321;Antioquia;Guatapé;8363;5420;2943
57;5347;Antioquia;Heliconia;5451;2318;3133
58;5353;Antioquia;Hispania;5469;3416;2053
59;5360;Antioquia;Itagui;276744;247918;28826
60;5361;Antioquia;Ituango;27074;7074;20000
61;5364;Antioquia;Jardín;14518;7659;6859
62;5368;Antioquia;Jericó;13640;7619;6021
63;5376;Antioquia;La Ceja;64889;54820;10069
64;5380;Antioquia;La Estrella;71545;60997;10548
65;5390;Antioquia;La Pintada;8114;7060;1054
66;5400;Antioquia;La Unión;21475;12724;8751
67;5411;Antioquia;Liborina;10028;2296;7732
68;5425;Antioquia;Maceo;8221;3093;5128
69;5440;Antioquia;Marinilla;64645;44230;20415
70;5467;Antioquia;Montebello;6680;1866;4814
71;5475;Antioquia;Murindó;4911;1760;3151
72;5480;Antioquia;Mutatá;13991;5091;8900
73;5483;Antioquia;Nariño;10153;3116;7037
74;5490;Antioquia;Necoclí;42281;10955;31326
75;5495;Antioquia;Nechí;25790;13174;12616
76;5501;Antioquia;Olaya;3127;217;2910
77;5541;Antioquia;Peñol;21049;11022;10027
78;5543;Antioquia;Peque;8097;2296;5801
79;5576;Antioquia;Pueblorrico;8664;4450;4214
80;5579;Antioquia;Puerto Berrío;39314;32623;6691
81;5585;Antioquia;Puerto Nare;14380;4381;9999
82;5591;Antioquia;Puerto Triunfo;18055;2926;15129
83;5604;Antioquia;Remedios;28415;11632;16783
84;5607;Antioquia;Retiro;23514;12479;11035
85;5615;Antioquia;Rionegro;135465;83007;52458
86;5628;Antioquia;Sabanalarga;9032;2955;6077
87;5631;Antioquia;Sabaneta;82375;70401;11974
88;5642;Antioquia;Salgar;18258;6718;11540
89;5647;Antioquia;San Andrés de Cuerquía;7235;2848;4387
90;5649;Antioquia;San Carlos;16247;7362;8885
91;5652;Antioquia;San Francisco;5648;2486;3162
92;5656;Antioquia;San Jerónimo;15361;6704;8657
93;5658;Antioquia;San José de La Montaña;3646;2353;1293
94;5659;Antioquia;San Juan de Urabá;20093;6624;13469
95;5660;Antioquia;San Luis;12995;7408;5587
96;5664;Antioquia;San Pedro;21949;11756;10193
97;5665;Antioquia;San Pedro de Uraba;30932;12494;18438
98;5667;Antioquia;San Rafael;15698;7891;7807
99;5670;Antioquia;San Roque;21519;6481;15038
100;5674;Antioquia;San Vicente;22093;5464;16629
101;5679;Antioquia;Santa Bárbara;26784;12083;14701
102;5686;Antioquia;Santa Rosa de Osos;36318;19896;16422
103;5690;Antioquia;Santo Domingo;12394;2808;9586
104;5697;Antioquia;El Santuario;35422;24614;10808
105;5736;Antioquia;Segovia;37900;30133;7767
106;5756;Antioquia;Sonson;36321;17169;19152
107;5761;Antioquia;Sopetrán;15053;6522;8531
108;5789;Antioquia;Támesis;16281;7256;9025
109;5790;Antioquia;Tarazá;26964;12657;14307
110;5792;Antioquia;Tarso;6184;3324;2860
111;5809;Antioquia;Titiribí;10775;4591;6184
112;5819;Antioquia;Toledo;4993;1700;3293
113;5837;Antioquia;Turbo;124552;48787;75765
114;5842;Antioquia;Uramita;6888;2111;4777
115;5847;Antioquia;Urrao;30127;15918;14209
116;5854;Antioquia;Valdivia;13801;3637;10164
117;5856;Antioquia;Valparaíso;6498;3639;2859
118;5858;Antioquia;Vegachí;11810;8055;3755
119;5861;Antioquia;Venecia;11602;5089;6513
120;5873;Antioquia;Vigía del Fuerte;9093;3102;5991
121;5885;Antioquia;Yalí;7608;3587;4021
122;5887;Antioquia;Yarumal;41542;29049;12493
123;5890;Antioquia;Yolombó;22538;6768;15770
124;5893;Antioquia;Yondó;19040;9640;9400
125;5895;Antioquia;Zaragoza;24651;11173;13478
126;8001;Atlántico;Barranquilla;1206319;1205284;1035
127;8078;Atlántico;Baranoa;62382;51730;10652
128;8137;Atlántico;Campo de La Cruz;22879;19961;2918
129;8141;Atlántico;Candelaria;15982;11461;4521
130;8296;Atlántico;Galapa;60708;56167;4541
131;8372;Atlántico;Juan de Acosta;20999;13095;7904
132;8421;Atlántico;Luruaco;28175;14251;13924
133;8433;Atlántico;Malambo;128203;119878;8325
134;8436;Atlántico;Manatí;19808;17499;2309
135;8520;Atlántico;Palmar de Varela;28932;27728;1204
136;8549;Atlántico;Piojó;6608;2812;3796
137;8558;Atlántico;Polonuevo;18197;15111;3086
138;8560;Atlántico;Ponedera;23848;13652;10196
139;8573;Atlántico;Puerto Colombia;49264;42803;6461
140;8606;Atlántico;Repelón;26200;17608;8592
141;8634;Atlántico;Sabanagrande;32334;30739;1595
142;8638;Atlántico;Sabanalarga;93261;69230;24031
143;8675;Atlántico;Santa Lucía;16023;13676;2347
144;8685;Atlántico;Santo Tomás;29829;28095;1734
145;8758;Atlántico;Soledad;603999;602644;1355
146;8770;Atlántico;Suan;11940;11239;701
147;8832;Atlántico;Tubará;17377;8774;8603
148;8849;Atlántico;Usiacurí;12250;11394;856
149;11001;Bogotá, DC;Bogotá, DC;7412566;7387400;25166
150;13001;Bolívar;Cartagena;973045;876885;96160
151;13006;Bolívar;Achí;24352;5648;18704
152;13030;Bolívar;Altos del Rosario;10972;4001;6971
153;13042;Bolívar;Arenal;7365;4496;2869
154;13052;Bolívar;Arjona;69503;55134;14369
155;13062;Bolívar;Arroyohondo;8254;4719;3535
156;13074;Bolívar;Barranco de Loba;14836;5722;9114
157;13140;Bolívar;Calamar;22474;12718;9756
158;13160;Bolívar;Cantagallo;8234;4520;3714
159;13188;Bolívar;Cicuco;13442;8758;4684
160;13212;Bolívar;Córdoba;15960;4206;11754
161;13222;Bolívar;Clemencia;14511;12169;2342
162;13244;Bolívar;El Carmen de Bolívar;70131;50844;19287
163;13248;Bolívar;El Guamo;8647;4748;3899
164;13268;Bolívar;El Peñón;7651;2886;4765
165;13300;Bolívar;Hatillo de Loba;12317;3166;9151
166;13430;Bolívar;Magangué;133270;92316;40954
167;13433;Bolívar;Mahates;27692;10402;17290
168;13440;Bolívar;Margarita;10673;1860;8813
169;13442;Bolívar;María La Baja;46112;20451;25661
170;13458;Bolívar;Montecristo;16389;4076;12313
171;13468;Bolívar;Mompós;44442;23090;21352
172;13473;Bolívar;Morales;22259;7293;14966
173;13490;Bolívar;Norosí;9212;2314;6898
174;13549;Bolívar;Pinillos;24218;3718;20500
175;13580;Bolívar;Regidor;6723;4223;2500
176;13600;Bolívar;Río Viejo ;10598;5071;5527
177;13620;Bolívar;San Cristóbal;8054;6221;1833
178;13647;Bolívar;San Estanislao;18251;12528;5723
179;13650;Bolívar;San Fernando;12536;2147;10389
180;13654;Bolívar;San Jacinto;23913;20711;3202
181;13655;Bolívar;San Jacinto del Cauca;9935;2566;7369
182;13657;Bolívar;San Juan Nepomuceno;36874;27379;9495
183;13667;Bolívar;San Martín de Loba;14774;7051;7723
184;13670;Bolívar;San Pablo;27190;20829;6361
185;13673;Bolívar;Santa Catalina;14563;5666;8897
186;13683;Bolívar;Santa Rosa;20963;19356;1607
187;13688;Bolívar;Santa Rosa del Sur;32646;19214;13432
188;13744;Bolívar;Simití;18110;6063;12047
189;13760;Bolívar;Soplaviento;10650;10455;195
190;13780;Bolívar;Talaigua Nuevo;13108;6278;6830
191;13810;Bolívar;Tiquisio;18035;6167;11868
192;13836;Bolívar;Turbaco;105166;97294;7872
193;13838;Bolívar;Turbaná;16403;12428;3975
194;13873;Bolívar;Villanueva;23777;20769;3008
195;13894;Bolívar;Zambrano;11880;10507;1373
196;15001;Boyacá;Tunja;172548;163894;8654
197;15022;Boyacá;Almeida;1910;321;1589
198;15047;Boyacá;Aquitania;15377;5777;9600
199;15051;Boyacá;Arcabuco;5831;2378;3453
200;15087;Boyacá;Belén;7481;4495;2986
201;15090;Boyacá;Berbeo;1596;406;1190
202;15092;Boyacá;Betéitiva;1963;327;1636
203;15097;Boyacá;Boavita;5059;2305;2754
204;15104;Boyacá;Boyacá;5089;761;4328
205;15106;Boyacá;Briceño;2198;487;1711
206;15109;Boyacá;Buenavista;4409;757;3652
207;15114;Boyacá;Busbanzá;1118;432;686
208;15131;Boyacá;Caldas;3143;245;2898
209;15135;Boyacá;Campohermoso;3121;767;2354
210;15162;Boyacá;Cerinza;3713;1653;2060
211;15172;Boyacá;Chinavita;3209;1231;1978
212;15176;Boyacá;Chiquinquirá;56054;49016;7038
213;15180;Boyacá;Chiscas;3994;879;3115
214;15183;Boyacá;Chita;8045;1976;6069
215;15185;Boyacá;Chitaraque;5830;1158;4672
216;15187;Boyacá;Chivatá;2788;470;2318
217;15189;Boyacá;Ciénega;4635;1207;3428
218;15204;Boyacá;Cómbita;12970;1286;11684
219;15212;Boyacá;Coper;3619;862;2757
220;15215;Boyacá;Corrales;2498;1561;937
221;15218;Boyacá;Covarachía;2806;492;2314
222;15223;Boyacá;Cubará;10319;2182;8137
223;15224;Boyacá;Cucaita;3725;1457;2268
224;15226;Boyacá;Cuítiva;1798;251;1547
225;15232;Boyacá;Chíquiza;4684;332;4352
226;15236;Boyacá;Chivor;2479;681;1798
227;15238;Boyacá;Duitama;122436;107520;14916
228;15244;Boyacá;El Cocuy;4215;2206;2009
229;15248;Boyacá;El Espino;3061;1358;1703
230;15272;Boyacá;Firavitoba;6662;2497;4165
231;15276;Boyacá;Floresta;3266;1152;2114
232;15293;Boyacá;Gachantivá;2789;557;2232
233;15296;Boyacá;Gameza;4850;1327;3523
234;15299;Boyacá;Garagoa;17932;12358;5574
235;15317;Boyacá;Guacamayas;1865;624;1241
236;15322;Boyacá;Guateque;10699;7631;3068
237;15325;Boyacá;Guayatá;3400;1117;2283
238;15332;Boyacá;Güicán;4279;1353;2926
239;15362;Boyacá;Iza;1947;1160;787
240;15367;Boyacá;Jenesano;7200;1696;5504
241;15368;Boyacá;Jericó;3929;1201;2728
242;15377;Boyacá;Labranzagrande;3526;1128;2398
243;15380;Boyacá;La Capilla;2689;1012;1677
244;15401;Boyacá;La Victoria;1118;400;718
245;15403;Boyacá;La Uvita;2999;1277;1722
246;15407;Boyacá;Villa de Leyva;16139;7897;8242
247;15425;Boyacá;Macanal;4976;1134;3842
248;15442;Boyacá;Maripí;5741;762;4979
249;15455;Boyacá;Miraflores;8847;5270;3577
250;15464;Boyacá;Mongua;4636;1992;2644
251;15466;Boyacá;Monguí;4234;2327;1907
252;15469;Boyacá;Moniquirá;22572;11539;11033
253;15476;Boyacá;Motavita;5569;742;4827
254;15480;Boyacá;Muzo;8597;5392;3205
255;15491;Boyacá;Nobsa;15976;5026;10950
256;15494;Boyacá;Nuevo Colón;5121;993;4128
257;15500;Boyacá;Oicatá;2821;400;2421
258;15507;Boyacá;Otanche;8018;3449;4569
259;15511;Boyacá;Pachavita;2467;520;1947
260;15514;Boyacá;Páez;3283;1353;1930
261;15516;Boyacá;Paipa;33535;20021;13514
262;15518;Boyacá;Pajarito;2390;960;1430
263;15522;Boyacá;Panqueba;1717;810;907
264;15531;Boyacá;Pauna;7185;2073;5112
265;15533;Boyacá;Paya;2593;481;2112
266;15537;Boyacá;Paz de Río;4285;2788;1497
267;15542;Boyacá;Pesca;6852;2245;4607
268;15550;Boyacá;Pisba;1763;527;1236
269;15572;Boyacá;Puerto Boyacá;46736;32979;13757
270;15580;Boyacá;Quípama;4889;1326;3563
271;15599;Boyacá;Ramiriquí;9887;4053;5834
272;15600;Boyacá;Ráquira;7877;2217;5660
273;15621;Boyacá;Rondón;2407;600;1807
274;15632;Boyacá;Saboyá;13588;978;12610
275;15638;Boyacá;Sáchica;5452;2567;2885
276;15646;Boyacá;Samacá;18298;7075;11223
277;15660;Boyacá;San Eduardo;1701;732;969
278;15664;Boyacá;San José de Pare;4988;978;4010
279;15667;Boyacá;San Luis de Gaceno;5499;2444;3055
280;15673;Boyacá;San Mateo;3332;1163;2169
281;15676;Boyacá;San Miguel de Sema;3009;412;2597
282;15681;Boyacá;San Pablo de Borbur;6608;745;5863
283;15686;Boyacá;Santana;7565;2525;5040
284;15690;Boyacá;Santa María;3559;2107;1452
285;15693;Boyacá;Santa Rosa de Viterbo;13066;7937;5129
286;15696;Boyacá;Santa Sofía;3179;1019;2160
287;15720;Boyacá;Sativanorte;2221;680;1541
288;15723;Boyacá;Sativasur;1097;302;795
289;15740;Boyacá;Siachoque;6729;1117;5612
290;15753;Boyacá;Soatá;9066;6407;2659
291;15755;Boyacá;Socotá;7298;1428;5870
292;15757;Boyacá;Socha;7938;4236;3702
293;15759;Boyacá;Sogamoso;127235;111815;15420
294;15761;Boyacá;Somondoco;2910;655;2255
295;15762;Boyacá;Sora;3019;486;2533
296;15763;Boyacá;Sotaquirá;8162;905;7257
297;15764;Boyacá;Soracá;5954;1461;4493
298;15774;Boyacá;Susacón;2717;604;2113
299;15776;Boyacá;Sutamarchán;6092;2103;3989
300;15778;Boyacá;Sutatenza;4233;732;3501
301;15790;Boyacá;Tasco;5882;1625;4257
302;15798;Boyacá;Tenza;3851;1127;2724
303;15804;Boyacá;Tibaná;9051;1729;7322
304;15806;Boyacá;Tibasosa;12940;4238;8702
305;15808;Boyacá;Tinjacá;3266;737;2529
306;15810;Boyacá;Tipacoque;3323;937;2386
307;15814;Boyacá;Toca;8767;4209;4558
308;15816;Boyacá;Togüí;4335;617;3718
309;15820;Boyacá;Tópaga;3617;1054;2563
310;15822;Boyacá;Tota;5179;854;4325
311;15832;Boyacá;Tununguá;1540;256;1284
312;15835;Boyacá;Turmequé;6118;2072;4046
313;15837;Boyacá;Tuta;8266;2320;5946
314;15839;Boyacá;Tutazá;2040;169;1871
315;15842;Boyacá;Umbita;7530;1019;6511
316;15861;Boyacá;Ventaquemada;15706;2345;13361
317;15879;Boyacá;Viracachá;2837;426;2411
318;15897;Boyacá;Zetaquira;4629;1163;3466
319;17001;Caldas;Manizales;434403;405234;29169
320;17013;Caldas;Aguadas;22823;11532;11291
321;17042;Caldas;Anserma;36149;20284;15865
322;17050;Caldas;Aranzazu;10557;6825;3732
323;17088;Caldas;Belalcázar;10660;4583;6077
324;17174;Caldas;Chinchiná;51271;44570;6701
325;17272;Caldas;Filadelfia;11451;3877;7574
326;17380;Caldas;La Dorada;71905;62536;9369
327;17388;Caldas;La Merced;6003;2151;3852
328;17433;Caldas;Manzanares;17928;10221;7707
329;17442;Caldas;Marmato;8888;964;7924
330;17444;Caldas;Marquetalia;13245;6348;6897
331;17446;Caldas;Marulanda;2607;823;1784
332;17486;Caldas;Neira;21024;11564;9460
333;17495;Caldas;Norcasia;6022;4007;2015
334;17513;Caldas;Pácora;15325;7430;7895
335;17524;Caldas;Palestina;15555;4963;10592
336;17541;Caldas;Pensilvania;19908;7706;12202
337;17614;Caldas;Riosucio;50775;18077;32698
338;17616;Caldas;Risaralda;10815;4217;6598
339;17653;Caldas;Salamina;19467;11359;8108
340;17662;Caldas;Samaná;20454;5924;14530
341;17665;Caldas;San José;4835;1282;3553
342;17777;Caldas;Supía;28642;13493;15149
343;17867;Caldas;Victoria;10157;4296;5861
344;17873;Caldas;Villamaría;64652;55894;8758
345;17877;Caldas;Viterbo;12734;10705;2029
346;18001;Caquetá;Florencia;168346;147939;20407
347;18029;Caquetá;Albania;4675;2060;2615
348;18094;Caquetá;Belén de Los Andaquies;11021;6753;4268
349;18150;Caquetá;Cartagena del Chairá;30399;15434;14965
350;18205;Caquetá;Curillo;7593;5261;2332
351;18247;Caquetá;El Doncello;19294;13522;5772
352;18256;Caquetá;El Paujil;18036;8858;9178
353;18410;Caquetá;La Montañita;14714;2467;12247
354;18460;Caquetá;Milán;9723;1001;8722
355;18479;Caquetá;Morelia;3698;2007;1691
356;18592;Caquetá;Puerto Rico;26517;14464;12053
357;18610;Caquetá;San José del Fragua;12797;6292;6505
358;18753;Caquetá;San Vicente del Caguán;50719;23432;27287
359;18756;Caquetá;Solano;11214;2782;8432
360;18785;Caquetá;Solita;6216;3672;2544
361;18860;Caquetá;Valparaíso;6887;2336;4551
362;19001;Cauca;Popayán;318059;266561;51498
363;19022;Cauca;Almaguer;18449;1346;17103
364;19050;Cauca;Argelia;26144;2700;23444
365;19075;Cauca;Balboa;21108;5393;15715
366;19100;Cauca;Bolívar;38048;5020;33028
367;19110;Cauca;Buenos Aires;31436;1218;30218
368;19130;Cauca;Cajibío;42014;2202;39812
369;19137;Cauca;Caldono;39946;2174;37772
370;19142;Cauca;Caloto;30181;5297;24884
371;19212;Cauca;Corinto;25286;12880;12406
372;19256;Cauca;El Tambo;53891;3003;50888
373;19290;Cauca;Florencia;5202;1224;3978
374;19300;Cauca;Guachené ;19671;6480;13191
375;19318;Cauca;Guapi;27616;13932;13684
376;19355;Cauca;Inzá;28879;1308;27571
377;19364;Cauca;Jambaló;17841;1895;15946
378;19392;Cauca;La Sierra;10749;1822;8927
379;19397;Cauca;La Vega;24501;1040;23461
380;19418;Cauca;López;18580;1875;16705
381;19450;Cauca;Mercaderes;22688;5953;16735
382;19455;Cauca;Miranda;31360;17930;13430
383;19473;Cauca;Morales;38838;2472;36366
384;19513;Cauca;Padilla;9937;4478;5459
385;19517;Cauca;Paez;45776;2971;42805
386;19532;Cauca;Patía;36848;13781;23067
387;19533;Cauca;Piamonte;8811;2109;6702
388;19548;Cauca;Piendamó;40818;14271;26547
389;19573;Cauca;Puerto Tejada;41615;36266;5349
390;19585;Cauca;Puracé;17272;1697;15575
391;19622;Cauca;Rosas;11475;1087;10388
392;19693;Cauca;San Sebastián;10948;668;10280
393;19698;Cauca;Santander de Quilichao;110445;52246;58199
394;19701;Cauca;Santa Rosa;5339;672;4667
395;19743;Cauca;Silvia;37337;4492;32845
396;19760;Cauca;Sotara;13939;571;13368
397;19780;Cauca;Suárez;31904;6380;25524
398;19785;Cauca;Sucre;9489;1633;7856
399;19807;Cauca;Timbío;35479;14562;20917
400;19809;Cauca;Timbiquí;26100;6266;19834
401;19821;Cauca;Toribio;35218;2441;32777
402;19824;Cauca;Totoró;24558;1319;23239
403;19845;Cauca;Villa Rica;20693;14267;6426
404;20001;Cesar;Valledupar;490075;431794;58281
405;20011;Cesar;Aguachica;109621;95851;13770
406;20013;Cesar;Agustín Codazzi;60768;48157;12611
407;20032;Cesar;Astrea;20120;10468;9652
408;20045;Cesar;Becerril;21611;16123;5488
409;20060;Cesar;Bosconia;40022;37676;2346
410;20175;Cesar;Chimichagua;34169;13721;20448
411;20178;Cesar;Chiriguaná;27694;16576;11118
412;20228;Cesar;Curumaní;37399;26422;10977
413;20238;Cesar;El Copey;30159;22469;7690
414;20250;Cesar;El Paso;37531;6922;30609
415;20295;Cesar;Gamarra;14973;9828;5145
416;20310;Cesar;González;4379;1414;2965
417;20383;Cesar;La Gloria;17150;6034;11116
418;20400;Cesar;La Jagua de Ibirico;46722;35513;11209
419;20443;Cesar;Manaure;10047;8389;1658
420;20517;Cesar;Pailitas;18566;13838;4728
421;20550;Cesar;Pelaya;20683;14363;6320
422;20570;Cesar;Pueblo Bello;27007;8556;18451
423;20614;Cesar;Río de Oro;16837;7859;8978
424;20621;Cesar;La Paz;27759;19622;8137
425;20710;Cesar;San Alberto;26247;20857;5390
426;20750;Cesar;San Diego;19022;10517;8505
427;20770;Cesar;San Martín;26674;14370;12304
428;20787;Cesar;Tamalameque;15339;6072;9267
429;23001;Córdoba ;Montería;490935;388499;102436
430;23068;Córdoba ;Ayapel;46968;27626;19342
431;23079;Córdoba ;Buenavista;21078;7755;13323
432;23090;Córdoba ;Canalete;15353;3840;11513
433;23162;Córdoba ;Cereté;105815;59224;46591
434;23168;Córdoba ;Chimá;17529;3817;13712
435;23182;Córdoba ;Chinú;47917;20083;27834
436;23189;Córdoba ;Ciénaga de Oro;59086;22469;36617
437;23300;Córdoba ;Cotorra;19041;5939;13102
438;23350;Córdoba ;La Apartada;14866;11380;3486
439;23417;Córdoba ;Lorica;113909;53420;60489
440;23419;Córdoba ;Los Córdobas;18717;3768;14949
441;23464;Córdoba ;Momil;19590;11825;7765
442;23466;Córdoba ;Montelíbano;81641;61589;20052
443;23500;Córdoba ;Moñitos;29833;6325;23508
444;23555;Córdoba ;Planeta Rica;64205;41228;22977
445;23570;Córdoba ;Pueblo Nuevo;35655;10167;25488
446;23574;Córdoba ;Puerto Escondido;23649;4209;19440
447;23580;Córdoba ;Puerto Libertador;41873;13220;28653
448;23586;Córdoba ;Purísima;17206;7217;9989
449;23660;Córdoba ;Sahagún;107636;53725;53911
450;23670;Córdoba ;San Andrés Sotavento;48610;9750;38860
451;23672;Córdoba ;San Antero;33878;15995;17883
452;23675;Córdoba ;San Bernardo del Viento;37007;9091;27916
453;23678;Córdoba ;San Carlos;26954;4629;22325
454;23682;Córdoba ;San José de Uré(1);13345;5160;8185
455;23686;Córdoba ;San Pelayo;51838;9105;42733
456;23807;Córdoba ;Tierralta;92349;42254;50095
457;23815;Córdoba ;Tuchín;52606;7576;45030
458;23855;Córdoba ;Valencia;35694;16434;19260
459;25001;Cundinamarca;Agua de Dios;11685;9113;2572
460;25019;Cundinamarca;Albán;6438;1715;4723
461;25035;Cundinamarca;Anapoima;14519;5801;8718
462;25040;Cundinamarca;Anolaima;13816;4327;9489
463;25053;Cundinamarca;Arbeláez;10860;4326;6534
464;25086;Cundinamarca;Beltrán;1789;362;1427
465;25095;Cundinamarca;Bituima;2467;451;2016
466;25099;Cundinamarca;Bojacá;9913;7680;2233
467;25120;Cundinamarca;Cabrera;4722;1114;3608
468;25123;Cundinamarca;Cachipay;9972;3511;6461
469;25126;Cundinamarca;Cajicá;82244;54111;28133
470;25148;Cundinamarca;Caparrapí;12569;3083;9486
471;25151;Cundinamarca;Caqueza;17099;7552;9547
472;25154;Cundinamarca;Carmen de Carupa;7580;2093;5487
473;25168;Cundinamarca;Chaguaní;4182;952;3230
474;25175;Cundinamarca;Chía;132181;105509;26672
475;25178;Cundinamarca;Chipaque;9467;2697;6770
476;25181;Cundinamarca;Choachí;10961;4160;6801
477;25183;Cundinamarca;Chocontá;20568;10554;10014
478;25200;Cundinamarca;Cogua;22067;7653;14414
479;25214;Cundinamarca;Cota;32691;20462;12229
480;25224;Cundinamarca;Cucunubá;7626;1131;6495
481;25245;Cundinamarca;El Colegio;23886;10251;13635
482;25258;Cundinamarca;El Peñón;4681;577;4104
483;25260;Cundinamarca;El Rosal;22065;18958;3107
484;25269;Cundinamarca;Facatativá;139441;125348;14093
485;25279;Cundinamarca;Fomeque;11986;5203;6783
486;25281;Cundinamarca;Fosca;5784;1367;4417
487;25286;Cundinamarca;Funza;93154;90671;2483
488;25288;Cundinamarca;Fúquene;4904;168;4736
489;25290;Cundinamarca;Fusagasugá;138498;114722;23776
490;25293;Cundinamarca;Gachala;4436;1546;2890
491;25295;Cundinamarca;Gachancipá;17026;11252;5774
492;25297;Cundinamarca;Gachetá;8425;3388;5037
493;25299;Cundinamarca;Gama;3120;710;2410
494;25307;Cundinamarca;Girardot;101018;95427;5591
495;25312;Cundinamarca;Granada;7179;1840;5339
496;25317;Cundinamarca;Guachetá;13285;5928;7357
497;25320;Cundinamarca;Guaduas;30524;13614;16910
498;25322;Cundinamarca;Guasca;15348;6121;9227
499;25324;Cundinamarca;Guataquí;2848;1204;1644
500;25326;Cundinamarca;Guatavita;6325;2212;4113
501;25328;Cundinamarca;Guayabal de Siquima;4444;1018;3426
502;25335;Cundinamarca;Guayabetal;6232;1967;4265
503;25339;Cundinamarca;Gutiérrez;3410;983;2427
504;25368;Cundinamarca;Jerusalén;2281;800;1481
505;25372;Cundinamarca;Junín;5823;833;4990
506;25377;Cundinamarca;La Calera;29868;13470;16398
507;25386;Cundinamarca;La Mesa;32694;16854;15840
508;25394;Cundinamarca;La Palma;9467;4125;5342
509;25398;Cundinamarca;La Peña;5911;1023;4888
510;25402;Cundinamarca;La Vega;16986;6213;10773
511;25407;Cundinamarca;Lenguazaque;10080;2798;7282
512;25426;Cundinamarca;Macheta;6124;1584;4540
513;25430;Cundinamarca;Madrid;112254;102710;9544
514;25436;Cundinamarca;Manta;3737;990;2747
515;25438;Cundinamarca;Medina;8014;4103;3911
516;25473;Cundinamarca;Mosquera;130221;128012;2209
517;25483;Cundinamarca;Nariño;2333;1641;692
518;25486;Cundinamarca;Nemocón;13171;6389;6782
519;25488;Cundinamarca;Nilo;10819;2752;8067
520;25489;Cundinamarca;Nimaima;3589;685;2904
521;25491;Cundinamarca;Nocaima;6092;1918;4174
522;25506;Cundinamarca;Venecia;4218;1202;3016
523;25513;Cundinamarca;Pacho;24413;12714;11699
524;25518;Cundinamarca;Paime;4186;507;3679
525;25524;Cundinamarca;Pandi;4973;1097;3876
526;25530;Cundinamarca;Paratebueno;8328;3455;4873
527;25535;Cundinamarca;Pasca;9105;2763;6342
528;25572;Cundinamarca;Puerto Salgar;15453;11082;4371
529;25580;Cundinamarca;Pulí;3327;679;2648
530;25592;Cundinamarca;Quebradanegra;4724;426;4298
531;25594;Cundinamarca;Quetame;5072;1358;3714
532;25596;Cundinamarca;Quipile;6291;656;5635
533;25599;Cundinamarca;Apulo;8192;3539;4653
534;25612;Cundinamarca;Ricaurte;12881;6867;6014
535;25645;Cundinamarca;San Antonio del Tequendama;11870;907;10963
536;25649;Cundinamarca;San Bernardo;8487;3488;4999
537;25653;Cundinamarca;San Cayetano;4846;601;4245
538;25658;Cundinamarca;San Francisco;10755;4384;6371
539;25662;Cundinamarca;San Juan de Río Seco;8181;2986;5195
540;25718;Cundinamarca;Sasaima;10711;2555;8156
541;25736;Cundinamarca;Sesquilé;11423;3425;7998
542;25740;Cundinamarca;Sibaté;33491;23644;9847
543;25743;Cundinamarca;Silvania;21625;6881;14744
544;25745;Cundinamarca;Simijaca;12847;7407;5440
545;25754;Cundinamarca;Soacha;660179;655025;5154
546;25758;Cundinamarca;Sopó;25782;17435;8347
547;25769;Cundinamarca;Subachoque;15690;7250;8440
548;25772;Cundinamarca;Suesca;17021;7443;9578
549;25777;Cundinamarca;Supatá;5203;1638;3565
550;25779;Cundinamarca;Susa;6454;2175;4279
551;25781;Cundinamarca;Sutatausa;5887;1885;4002
552;25785;Cundinamarca;Tabio;21665;6317;15348
553;25793;Cundinamarca;Tausa;8067;1370;6697
554;25797;Cundinamarca;Tena;9567;596;8971
555;25799;Cundinamarca;Tenjo;21935;8624;13311
556;25805;Cundinamarca;Tibacuy;4335;549;3786
557;25807;Cundinamarca;Tibirita;3158;520;2638
558;25815;Cundinamarca;Tocaima;15735;9589;6146
559;25817;Cundinamarca;Tocancipá;39996;15355;24641
560;25823;Cundinamarca;Topaipí;4139;674;3465
561;25839;Cundinamarca;Ubalá;7717;1432;6285
562;25841;Cundinamarca;Ubaque;6727;1094;5633
563;25843;Cundinamarca;Villa de San Diego de Ubate;42558;31042;11516
564;25845;Cundinamarca;Une;6945;3618;3327
565;25851;Cundinamarca;Útica;4246;2406;1840
566;25862;Cundinamarca;Vergara;6847;1213;5634
567;25867;Cundinamarca;Vianí;4339;1449;2890
568;25871;Cundinamarca;Villagómez;1758;610;1148
569;25873;Cundinamarca;Villapinzón;17187;6373;10814
570;25875;Cundinamarca;Villeta;26873;17985;8888
571;25878;Cundinamarca;Viotá;13234;4286;8948
572;25885;Cundinamarca;Yacopí;12322;2848;9474
573;25898;Cundinamarca;Zipacón;4659;1228;3431
574;25899;Cundinamarca;Zipaquirá;130537;106461;24076
575;27001;Chocó;Quibdó;129237;113124;16113
576;27006;Chocó;Acandí;13999;6895;7104
577;27025;Chocó;Alto Baudo;27584;3356;24228
578;27050;Chocó;Atrato;6063;2858;3205
579;27073;Chocó;Bagadó;11011;2589;8422
580;27075;Chocó;Bahía Solano;10123;6172;3951
581;27077;Chocó;Bajo Baudó;29957;7041;22916
582;27099;Chocó;Bojaya;12073;1158;10915
583;27135;Chocó;El Cantón del San Pablo;6116;2844;3272
584;27150;Chocó;Carmen del Darien;18433;2276;16157
585;27160;Chocó;Cértegui;5635;3321;2314
586;27205;Chocó;Condoto;12663;9696;2967
587;27245;Chocó;El Carmen de Atrato;8193;2510;5683
588;27250;Chocó;El Litoral del San Juan;21669;1843;19826
589;27361;Chocó;Istmina;30742;22258;8484
590;27372;Chocó;Juradó;6685;2511;4174
591;27413;Chocó;Lloró;9786;3376;6410
592;27425;Chocó;Medio Atrato;10672;944;9728
593;27430;Chocó;Medio Baudó;15109;2307;12802
594;27450;Chocó;Medio San Juan;10579;2622;7957
595;27491;Chocó;Nóvita;9153;3498;5655
596;27495;Chocó;Nuquí;16223;1685;14538
597;27580;Chocó;Río Iro;5467;1539;3928
598;27600;Chocó;Río Quito;8236;2335;5901
599;27615;Chocó;Riosucio;53449;14299;39150
600;27660;Chocó;San José del Palmar;5114;1355;3759
601;27745;Chocó;Sipí;3174;742;2432
602;27787;Chocó;Tadó;18011;10753;7258
603;27800;Chocó;Unguía;12854;4343;8511
604;27810;Chocó;Unión Panamericana;6816;2944;3872
605;41001;Huila;Neiva;357392;335994;21398
606;41006;Huila;Acevedo;24774;4640;20134
607;41013;Huila;Agrado;8800;5664;3136
608;41016;Huila;Aipe;16163;10553;5610
609;41020;Huila;Algeciras;22481;10806;11675
610;41026;Huila;Altamira;4275;2425;1850
611;41078;Huila;Baraya;8338;3975;4363
612;41132;Huila;Campoalegre;31087;23787;7300
613;41206;Huila;Colombia;7285;2205;5080
614;41244;Huila;Elías;4211;1439;2772
615;41298;Huila;Garzón;72382;38923;33459
616;41306;Huila;Gigante;24583;9766;14817
617;41319;Huila;Guadalupe;17890;5497;12393
618;41349;Huila;Hobo;7286;5639;1647
619;41357;Huila;Iquira;9248;2652;6596
620;41359;Huila;Isnos;25186;6148;19038
621;41378;Huila;La Argentina;12866;4796;8070
622;41396;Huila;La Plata;61026;25791;35235
623;41483;Huila;Nátaga;6469;2648;3821
624;41503;Huila;Oporapa;11629;2355;9274
625;41518;Huila;Paicol;6583;2775;3808
626;41524;Huila;Palermo;26279;12475;13804
627;41530;Huila;Palestina;11159;1755;9404
628;41548;Huila;Pital;13787;4892;8895
629;41551;Huila;Pitalito;124359;73319;51040
630;41615;Huila;Rivera;24312;11720;12592
631;41660;Huila;Saladoblanco;10444;1844;8600
632;41668;Huila;San Agustín;33028;11158;21870
633;41676;Huila;Santa María;10405;2527;7878
634;41770;Huila;Suaza;21853;4507;17346
635;41791;Huila;Tarqui;17440;5499;11941
636;41797;Huila;Tesalia;10697;5317;5380
637;41799;Huila;Tello;11800;5173;6627
638;41801;Huila;Teruel;8052;4270;3782
639;41807;Huila;Timaná;21799;7883;13916
640;41872;Huila;Villavieja;7288;2459;4829
641;41885;Huila;Yaguará;7730;6421;1309
642;44001;La Guajira;Riohacha;188014;126103;61911
643;44035;La Guajira;Albania;29148;15783;13365
644;44078;La Guajira;Barrancas;35743;15818;19925
645;44090;La Guajira;Dibulla;37740;4884;32856
646;44098;La Guajira;Distracción;13016;5871;7145
647;44110;La Guajira;El Molino;7185;6383;802
648;44279;La Guajira;Fonseca;42772;35754;7018
649;44378;La Guajira;Hatonuevo;20044;11905;8139
650;44420;La Guajira;La Jagua del Pilar;3498;2162;1336
651;44430;La Guajira;Maicao;170582;103354;67228
652;44560;La Guajira;Manaure;83072;8625;74447
653;44650;La Guajira;San Juan del Cesar;46953;30385;16568
654;44847;La Guajira;Uribia;163462;7698;155764
655;44855;La Guajira;Urumita;10985;9423;1562
656;44874;La Guajira;Villanueva;28346;26488;1858
657;47001;Magdalena;Santa Marta;499192;455299;43893
658;47030;Magdalena;Algarrobo;15511;10096;5415
659;47053;Magdalena;Aracataca;39857;23623;16234
660;47058;Magdalena;Ariguaní;30218;19075;11143
661;47161;Magdalena;Cerro San Antonio;9890;5365;4525
662;47170;Magdalena;Chivolo;21862;13782;8080
663;47189;Magdalena;Ciénaga;120071;104999;15072
664;47205;Magdalena;Concordia;10505;4177;6328
665;47245;Magdalena;El Banco;65457;41881;23576
666;47258;Magdalena;El Piñon;22530;7445;15085
667;47268;Magdalena;El Retén;19697;15549;4148
668;47288;Magdalena;Fundación;66433;56814;9619
669;47318;Magdalena;Guamal;26620;8437;18183
670;47460;Magdalena;Nueva Granada;19663;8132;11531
671;47541;Magdalena;Pedraza;9196;3017;6179
672;47545;Magdalena;Pijiño del Carmen;12093;5710;6383
673;47551;Magdalena;Pivijay;37341;21777;15564
674;47555;Magdalena;Plato;61766;47141;14625
675;47570;Magdalena;Puebloviejo;29824;9897;19927
676;47605;Magdalena;Remolino;11445;7375;4070
677;47660;Magdalena;Sabanas de San Angel;15644;4559;11085
678;47675;Magdalena;Salamina;10733;7151;3582
679;47692;Magdalena;San Sebastián de Buenavista;19523;6071;13452
680;47703;Magdalena;San Zenón;11681;1470;10211
681;47707;Magdalena;Santa Ana;25438;13851;11587
682;47720;Magdalena;Santa Bárbara de Pinto;10575;6616;3959
683;47745;Magdalena;Sitionuevo;27128;14239;12889
684;47798;Magdalena;Tenerife;13236;6511;6725
685;47960;Magdalena;Zapayán;9895;3846;6049
686;47980;Magdalena;Zona Bananera;68722;4415;64307
687;50001;Meta;Villavicencio;531275;492052;39223
688;50006;Meta;Acacías;88023;67906;20117
689;50110;Meta;Barranca de Upía;6440;4425;2015
690;50124;Meta;Cabuyaro;6062;2993;3069
691;50150;Meta;Castilla la Nueva;14300;6154;8146
692;50223;Meta;Cubarral;6963;4576;2387
693;50226;Meta;Cumaral;22831;15006;7825
694;50245;Meta;El Calvario;1776;590;1186
695;50251;Meta;El Castillo;7977;3020;4957
696;50270;Meta;El Dorado;3888;1412;2476
697;50287;Meta;Fuente de Oro;12129;6923;5206
698;50313;Meta;Granada;68876;58293;10583
699;50318;Meta;Guamal;14119;9609;4510
700;50325;Meta;Mapiripán;7007;2471;4536
701;50330;Meta;Mesetas;11159;4546;6613
702;50350;Meta;La Macarena;26890;4723;22167
703;50370;Meta;Uribe;9284;2128;7156
704;50400;Meta;Lejanías;11463;4823;6640
705;50450;Meta;Puerto Concordia;8390;3420;4970
706;50568;Meta;Puerto Gaitán;41513;20659;20854
707;50573;Meta;Puerto López;30399;18575;11824
708;50577;Meta;Puerto Lleras;10423;4087;6336
709;50590;Meta;Puerto Rico;13061;6439;6622
710;50606;Meta;Restrepo;18268;12190;6078
711;50680;Meta;San Carlos de Guaroa;12296;6300;5996
712;50683;Meta;San Juan de Arama;9118;4357;4761
713;50686;Meta;San Juanito;1307;672;635
714;50689;Meta;San Martín;26707;19458;7249
715;50711;Meta;Vistahermosa;17778;7254;10524
716;52001;Nariño;Pasto;392930;308095;84835
717;52019;Nariño;Albán;9642;2691;6951
718;52022;Nariño;Aldana;7392;1549;5843
719;52036;Nariño;Ancuyá;8801;2147;6654
720;52051;Nariño;Arboleda;8443;1172;7271
721;52079;Nariño;Barbacoas;55633;12075;43558
722;52083;Nariño;Belén;6322;3262;3060
723;52110;Nariño;Buesaco;23908;6552;17356
724;52203;Nariño;Colón;8526;1089;7437
725;52207;Nariño;Consaca;13784;2146;11638
726;52210;Nariño;Contadero;7270;1310;5960
727;52215;Nariño;Córdoba;15516;3081;12435
728;52224;Nariño;Cuaspud;9201;2708;6493
729;52227;Nariño;Cumbal;36864;6835;30029
730;52233;Nariño;Cumbitara;5948;1608;4340
731;52240;Nariño;Chachagüí;15354;4332;11022
732;52250;Nariño;El Charco;22505;7234;15271
733;52254;Nariño;El Peñol;7446;1340;6106
734;52256;Nariño;El Rosario;12280;1781;10499
735;52258;Nariño;El Tablón de Gómez;14342;1583;12759
736;52260;Nariño;El Tambo;14283;5251;9032
737;52287;Nariño;Funes;7222;3091;4131
738;52317;Nariño;Guachucal;19450;3071;16379
739;52320;Nariño;Guaitarilla;11582;4378;7204
740;52323;Nariño;Gualmatán;7057;2994;4063
741;52352;Nariño;Iles;7662;2133;5529
742;52354;Nariño;Imués;7657;1016;6641
743;52356;Nariño;Ipiales;116136;77343;38793
744;52378;Nariño;La Cruz;18754;8018;10736
745;52381;Nariño;La Florida;10104;1980;8124
746;52385;Nariño;La Llanada;6492;3156;3336
747;52390;Nariño;La Tola;7411;2928;4483
748;52399;Nariño;La Unión;31858;12793;19065
749;52405;Nariño;Leiva;9768;2967;6801
750;52411;Nariño;Linares;10236;2230;8006
751;52418;Nariño;Los Andes;9547;4376;5171
752;52427;Nariño;Magüi;24705;7325;17380
753;52435;Nariño;Mallama;8976;1218;7758
754;52473;Nariño;Mosquera;11984;5677;6307
755;52480;Nariño;Nariño;4364;2653;1711
756;52490;Nariño;Olaya Herrera;25358;10859;14499
757;52506;Nariño;Ospina;7105;1965;5140
758;52520;Nariño;Francisco Pizarro;14193;5423;8770
759;52540;Nariño;Policarpa;9897;2596;7301
760;52560;Nariño;Potosí;10414;2097;8317
761;52565;Nariño;Providencia;5572;1501;4071
762;52573;Nariño;Puerres;8581;3451;5130
763;52585;Nariño;Pupiales;17491;6192;11299
764;52612;Nariño;Ricaurte;19631;2399;17232
765;52621;Nariño;Roberto Payán;12667;3389;9278
766;52678;Nariño;Samaniego;29414;9462;19952
767;52683;Nariño;Sandoná;20773;10112;10661
768;52685;Nariño;San Bernardo;9202;2595;6607
769;52687;Nariño;San Lorenzo;18473;2180;16293
770;52693;Nariño;San Pablo;15389;4051;11338
771;52694;Nariño;San Pedro de Cartago;6843;849;5994
772;52696;Nariño;Santa Bárbara;13427;3608;9819
773;52699;Nariño;Santacruz;10796;1529;9267
774;52720;Nariño;Sapuyes;7346;1436;5910
775;52786;Nariño;Taminango;17854;3999;13855
776;52788;Nariño;Tangua;13507;2763;10744
777;52835;Nariño;San Andrés de Tumaco;253637;86320;167317
778;52838;Nariño;Túquerres;44729;17302;27427
779;52885;Nariño;Yacuanquer;10938;3326;7612
780;54001;Norte de Santander;Cúcuta;711715;685445;26270
781;54003;Norte de Santander;Abrego;31786;15896;15890
782;54051;Norte de Santander;Arboledas;9605;2207;7398
783;54099;Norte de Santander;Bochalema;8105;3038;5067
784;54109;Norte de Santander;Bucarasica;6248;502;5746
785;54125;Norte de Santander;Cácota;2781;913;1868
786;54128;Norte de Santander;Cachirá;10995;1772;9223
787;54172;Norte de Santander;Chinácota;17263;11083;6180
788;54174;Norte de Santander;Chitagá;11564;4331;7233
789;54206;Norte de Santander;Convención;18463;7417;11046
790;54223;Norte de Santander;Cucutilla;8095;1502;6593
791;54239;Norte de Santander;Durania;4541;2216;2325
792;54245;Norte de Santander;El Carmen;13144;2196;10948
793;54250;Norte de Santander;El Tarra;20093;8371;11722
794;54261;Norte de Santander;El Zulia;26700;16307;10393
795;54313;Norte de Santander;Gramalote;7295;2482;4813
796;54344;Norte de Santander;Hacarí;9998;1339;8659
797;54347;Norte de Santander;Herrán;6755;1204;5551
798;54377;Norte de Santander;Labateca;6268;1619;4649
799;54385;Norte de Santander;La Esperanza;11358;1660;9698
800;54398;Norte de Santander;La Playa;7582;851;6731
801;54405;Norte de Santander;Los Patios;89091;86266;2825
802;54418;Norte de Santander;Lourdes;3954;1831;2123
803;54480;Norte de Santander;Mutiscua;4163;796;3367
804;54498;Norte de Santander;Ocaña;118273;106159;12114
805;54518;Norte de Santander;Pamplona;50025;46013;4012
806;54520;Norte de Santander;Pamplonita;5402;1091;4311
807;54553;Norte de Santander;Puerto Santander;8502;7938;564
808;54599;Norte de Santander;Ragonvalia;5899;2874;3025
809;54660;Norte de Santander;Salazar;10205;3845;6360
810;54670;Norte de Santander;San Calixto;12011;2008;10003
811;54673;Norte de Santander;San Cayetano;6978;2288;4690
812;54680;Norte de Santander;Santiago;3361;1749;1612
813;54720;Norte de Santander;Sardinata;25142;9398;15744
814;54743;Norte de Santander;Silos;6162;871;5291
815;54800;Norte de Santander;Teorama;16193;2518;13675
816;54810;Norte de Santander;Tibú;53586;19627;33959
817;54820;Norte de Santander;Toledo;15440;5273;10167
818;54871;Norte de Santander;Villa Caro;4996;2179;2817
819;54874;Norte de Santander;Villa del Rosario;101952;98637;3315
820;63001;Quindio;Armenia;295208;287245;7963
821;63111;Quindio;Buenavista;3095;1212;1883
822;63130;Quindio;Calarca;72783;56505;16278
823;63190;Quindio;Circasia;28162;21025;7137
824;63212;Quindio;Córdoba;5642;3363;2279
825;63272;Quindio;Filandia;12066;6640;5426
826;63302;Quindio;Génova;7516;4269;3247
827;63401;Quindio;La Tebaida;33451;29752;3699
828;63470;Quindio;Montenegro;36751;30130;6621
829;63548;Quindio;Pijao;5219;2977;2242
830;63594;Quindio;Quimbaya;30751;24913;5838
831;63690;Quindio;Salento;9260;3879;5381
832;66001;Risaralda;Pereira;467269;385838;81431
833;66045;Risaralda;Apía;12406;5453;6953
834;66075;Risaralda;Balboa;6423;1518;4905
835;66088;Risaralda;Belén de Umbría;24690;12460;12230
836;66170;Risaralda;Dosquebradas;217178;204280;12898
837;66318;Risaralda;Guática;12158;3558;8600
838;66383;Risaralda;La Celia;7514;2881;4633
839;66400;Risaralda;La Virginia;27923;27189;734
840;66440;Risaralda;Marsella;16940;8521;8419
841;66456;Risaralda;Mistrató;16950;3892;13058
842;66572;Risaralda;Pueblo Rico;16156;2740;13416
843;66594;Risaralda;Quinchía;27292;7209;20083
844;66682;Risaralda;Santa Rosa de Cabal;77838;64297;13541
845;66687;Risaralda;Santuario;12664;6328;6336
846;68001;Santander;Bucaramanga;581130;570752;10378
847;68013;Santander;Aguada;1855;313;1542
848;68020;Santander;Albania;4129;597;3532
849;68051;Santander;Aratoca;8229;2380;5849
850;68077;Santander;Barbosa;31050;23249;7801
851;68079;Santander;Barichara;10486;3113;7373
852;68081;Santander;Barrancabermeja;203537;177272;26265
853;68092;Santander;Betulia;5941;1313;4628
854;68101;Santander;Bolívar;11287;1495;9792
855;68121;Santander;Cabrera;1937;395;1542
856;68132;Santander;California;2130;931;1199
857;68147;Santander;Capitanejo;5505;3452;2053
858;68152;Santander;Carcasí;4292;640;3652
859;68160;Santander;Cepitá;2015;517;1498
860;68162;Santander;Cerrito;6729;3329;3400
861;68167;Santander;Charalá;12270;7218;5052
862;68169;Santander;Charta;2888;716;2172
863;68176;Santander;Chima;2875;810;2065
864;68179;Santander;Chipatá;5075;637;4438
865;68190;Santander;Cimitarra;32947;13943;19004
866;68207;Santander;Concepción;5738;2780;2958
867;68209;Santander;Confines;3159;687;2472
868;68211;Santander;Contratación;3679;2798;881
869;68217;Santander;Coromoro;5015;723;4292
870;68229;Santander;Curití;12717;4577;8140
871;68235;Santander;El Carmen de Chucurí;20916;2821;18095
872;68245;Santander;El Guacamayo;2167;677;1490
873;68250;Santander;El Peñón;5279;712;4567
874;68255;Santander;El Playón;13713;7037;6676
875;68264;Santander;Encino;2552;526;2026
876;68266;Santander;Enciso;3461;849;2612
877;68271;Santander;Florián;5562;1218;4344
878;68276;Santander;Floridablanca;291935;280025;11910
879;68296;Santander;Galán;2886;812;2074
880;68298;Santander;Gambita;4021;653;3368
881;68307;Santander;Girón;160403;141107;19296
882;68318;Santander;Guaca;5916;1508;4408
883;68320;Santander;Guadalupe;4511;1693;2818
884;68322;Santander;Guapotá;2375;665;1710
885;68324;Santander;Guavatá;4230;1027;3203
886;68327;Santander;Güepsa;5114;3071;2043
887;68344;Santander;Hato;2328;657;1671
888;68368;Santander;Jesús María;3342;719;2623
889;68370;Santander;Jordán;1314;99;1215
890;68377;Santander;La Belleza;6198;1696;4502
891;68385;Santander;Landázuri;10384;3182;7202
892;68397;Santander;La Paz;4953;756;4197
893;68406;Santander;Lebríja;41835;22732;19103
894;68418;Santander;Los Santos;14106;1643;12463
895;68425;Santander;Macaravita;2171;280;1891
896;68432;Santander;Málaga;20945;18091;2854
897;68444;Santander;Matanza;4976;1445;3531
898;68464;Santander;Mogotes;10527;4135;6392
899;68468;Santander;Molagavita;4137;620;3517
900;68498;Santander;Ocamonte;5661;809;4852
901;68500;Santander;Oiba;10800;4791;6009
902;68502;Santander;Onzaga;4183;1232;2951
903;68522;Santander;Palmar;1361;467;894
904;68524;Santander;Palmas del Socorro;2535;779;1756
905;68533;Santander;Páramo;4654;1251;3403
906;68547;Santander;Piedecuesta;170625;139273;31352
907;68549;Santander;Pinchote;5162;1072;4090
908;68572;Santander;Puente Nacional;14654;5440;9214
909;68573;Santander;Puerto Parra;7640;2605;5035
910;68575;Santander;Puerto Wilches;32791;16175;16616
911;68615;Santander;Rionegro;26438;6338;20100
912;68655;Santander;Sabana de Torres;33055;22512;10543
913;68669;Santander;San Andrés;8683;3121;5562
914;68673;Santander;San Benito;2950;277;2673
915;68679;Santander;San Gil;56037;49050;6987
916;68682;Santander;San Joaquín;2241;819;1422
917;68684;Santander;San José de Miranda;4367;889;3478
918;68686;Santander;San Miguel;2531;629;1902
919;68689;Santander;San Vicente de Chucurí;33133;12288;20845
920;68705;Santander;Santa Bárbara;2401;265;2136
921;68720;Santander;Santa Helena del Opón;3389;768;2621
922;68745;Santander;Simacota;10042;2185;7857
923;68755;Santander;Socorro;32158;26232;5926
924;68770;Santander;Suaita;10031;2136;7895
925;68773;Santander;Sucre;7202;550;6652
926;68780;Santander;Suratá;3975;909;3066
927;68820;Santander;Tona;7373;538;6835
928;68855;Santander;Valle de San José;6084;2408;3676
929;68861;Santander;Vélez;24356;13159;11197
930;68867;Santander;Vetas;2114;729;1385
931;68872;Santander;Villanueva;7873;4564;3309
932;68895;Santander;Zapatoca;9466;6274;3192
933;70001;Sucre;Sincelejo;277773;249323;28450
934;70110;Sucre;Buenavista;10441;8317;2124
935;70124;Sucre;Caimito;15231;3821;11410
936;70204;Sucre;Coloso;8623;3832;4791
937;70215;Sucre;Corozal;67371;51372;15999
938;70221;Sucre;Coveñas;18250;10856;7394
939;70230;Sucre;Chalán;4466;2853;1613
940;70233;Sucre;El Roble;9944;4340;5604
941;70235;Sucre;Galeras;21982;11997;9985
942;70265;Sucre;Guaranda;17713;7122;10591
943;70400;Sucre;La Unión;12349;5934;6415
944;70418;Sucre;Los Palmitos;22880;11137;11743
945;70429;Sucre;Majagual;36650;10205;26445
946;70473;Sucre;Morroa;15061;9031;6030
947;70508;Sucre;Ovejas;22871;11409;11462
948;70523;Sucre;Palmito;14114;4905;9209
949;70670;Sucre;Sampués;46455;23452;23003
950;70678;Sucre;San Benito Abad;28673;5966;22707
951;70702;Sucre;San Juan de Betulia;13535;6907;6628
952;70708;Sucre;San Marcos;57672;32275;25397
953;70713;Sucre;San Onofre;49633;19008;30625
954;70717;Sucre;San Pedro;18590;12204;6386
955;70742;Sucre;San Luis de Sincé;30773;22672;8101
956;70771;Sucre;Sucre;29552;7205;22347
957;70820;Sucre;Santiago de Tolú;32922;26401;6521
958;70823;Sucre;Tolú Viejo;21339;6545;14794
959;73001;Tolima;Ibagué;529635;492554;37081
960;73024;Tolima;Alpujarra;4544;1991;2553
961;73026;Tolima;Alvarado;8697;3236;5461
962;73030;Tolima;Ambalema;6657;5261;1396
963;73043;Tolima;Anzoátegui;10217;1469;8748
964;73055;Tolima;Armero;12696;8184;4512
965;73067;Tolima;Ataco;19330;4820;14510
966;73124;Tolima;Cajamarca;18471;9461;9010
967;73148;Tolima;Carmen de Apicalá;10117;7627;2490
968;73152;Tolima;Casabianca;6373;1720;4653
969;73168;Tolima;Chaparral;50367;28615;21752
970;73200;Tolima;Coello;8248;1482;6766
971;73217;Tolima;Coyaima;22813;3836;18977
972;73226;Tolima;Cunday;8745;2397;6348
973;73236;Tolima;Dolores;8359;3503;4856
974;73268;Tolima;Espinal;70494;50664;19830
975;73270;Tolima;Falan;7693;1764;5929
976;73275;Tolima;Flandes;28389;24551;3838
977;73283;Tolima;Fresno;31069;15713;15356
978;73319;Tolima;Guamo;32940;16656;16284
979;73347;Tolima;Herveo;7363;2179;5184
980;73349;Tolima;Honda;24693;23658;1035
981;73352;Tolima;Icononzo;11887;3595;8292
982;73408;Tolima;Lérida;18574;13735;4839
983;73411;Tolima;Líbano;36773;23605;13168
984;73443;Tolima;Mariquita;37770;27907;9863
985;73449;Tolima;Melgar;36536;29749;6787
986;73461;Tolima;Murillo;4113;1758;2355
987;73483;Tolima;Natagaima;14835;7841;6994
988;73504;Tolima;Ortega;34607;6946;27661
989;73520;Tolima;Palocabildo;9730;3000;6730
990;73547;Tolima;Piedras;6711;2280;4431
991;73555;Tolima;Planadas;25764;6736;19028
992;73563;Tolima;Prado;8498;3745;4753
993;73585;Tolima;Purificación;23536;13186;10350
994;73616;Tolima;Rioblanco;22771;3724;19047
995;73622;Tolima;Roncesvalles;5459;1875;3584
996;73624;Tolima;Rovira;21674;10080;11594
997;73671;Tolima;Saldaña;14435;8502;5933
998;73675;Tolima;San Antonio;12896;4351;8545
999;73678;Tolima;San Luis;13553;3765;9788
1000;73686;Tolima;Santa Isabel;5769;2171;3598
1001;73770;Tolima;Suárez;3813;1539;2274
1002;73854;Tolima;Valle de San Juan;5345;2104;3241
1003;73861;Tolima;Venadillo;12817;8639;4178
1004;73870;Tolima;Villahermosa;9283;3364;5919
1005;73873;Tolima;Villarrica;5128;1968;3160
1006;76001;Valle del Cauca;Cali;2227642;2172527;55115
1007;76020;Valle del Cauca;Alcalá;14062;10398;3664
1008;76036;Valle del Cauca;Andalucía;22436;17413;5023
1009;76041;Valle del Cauca;Ansermanuevo;17448;10285;7163
1010;76054;Valle del Cauca;Argelia;5397;2852;2545
1011;76100;Valle del Cauca;Bolívar;16021;4414;11607
1012;76109;Valle del Cauca;Buenaventura;308188;235064;73124
1013;76111;Valle del Cauca;Guadalajara de Buga;127545;110905;16640
1014;76113;Valle del Cauca;Bugalagrande;24318;12670;11648
1015;76122;Valle del Cauca;Caicedonia;28825;23840;4985
1016;76126;Valle del Cauca;Calima;18054;11469;6585
1017;76130;Valle del Cauca;Candelaria;91825;23579;68246
1018;76147;Valle del Cauca;Cartago;135729;131641;4088
1019;76233;Valle del Cauca;Dagua;48443;10930;37513
1020;76243;Valle del Cauca;El Águila;8909;2407;6502
1021;76246;Valle del Cauca;El Cairo;6845;3198;3647
1022;76248;Valle del Cauca;El Cerrito;56470;35977;20493
1023;76250;Valle del Cauca;El Dovio;8886;5397;3489
1024;76275;Valle del Cauca;Florida;57374;40195;17179
1025;76306;Valle del Cauca;Ginebra;22741;10242;12499
1026;76318;Valle del Cauca;Guacarí;33191;20421;12770
1027;76364;Valle del Cauca;Jamundí;159877;123615;36262
1028;76377;Valle del Cauca;La Cumbre;16316;2901;13415
1029;76400;Valle del Cauca;La Unión;33953;26991;6962
1030;76403;Valle del Cauca;La Victoria;12174;9082;3092
1031;76497;Valle del Cauca;Obando;12312;8949;3363
1032;76520;Valle del Cauca;Palmira;349294;275254;74040
1033;76563;Valle del Cauca;Pradera;47615;41422;6193
1034;76606;Valle del Cauca;Restrepo;15307;10047;5260
1035;76616;Valle del Cauca;Riofrío;15554;7358;8196
1036;76622;Valle del Cauca;Roldanillo;36797;27626;9171
1037;76670;Valle del Cauca;San Pedro;16942;7571;9371
1038;76736;Valle del Cauca;Sevilla;42133;31816;10317
1039;76823;Valle del Cauca;Toro;14612;9968;4644
1040;76828;Valle del Cauca;Trujillo;19226;8857;10369
1041;76834;Valle del Cauca;Tuluá;212685;174951;37734
1042;76845;Valle del Cauca;Ulloa;5465;2549;2916
1043;76863;Valle del Cauca;Versalles;7263;4094;3169
1044;76869;Valle del Cauca;Vijes;12734;7899;4835
1045;76890;Valle del Cauca;Yotoco;16019;8326;7693
1046;76892;Valle del Cauca;Yumbo;107334;92630;14704
1047;76895;Valle del Cauca;Zarzal;41925;31812;10113
1048;81001;Arauca;Arauca;85585;74195;11390
1049;81065;Arauca;Arauquita;49841;13720;36121
1050;81220;Arauca;Cravo Norte;3925;2682;1243
1051;81300;Arauca;Fortul;18938;9886;9052
1052;81591;Arauca;Puerto Rondón;4399;2952;1447
1053;81736;Arauca;Saravena;55554;42415;13139
1054;81794;Arauca;Tame;43932;26784;17148
1055;85001;Casanare;Yopal;168433;143619;24814
1056;85010;Casanare;Aguazul;36915;26517;10398
1057;85015;Casanare;Chameza;2500;1499;1001
1058;85125;Casanare;Hato Corozal;12328;5167;7161
1059;85136;Casanare;La Salina;1417;636;781
1060;85139;Casanare;Maní;17211;11216;5995
1061;85162;Casanare;Monterrey;17537;12178;5359
1062;85225;Casanare;Nunchía;8826;1904;6922
1063;85230;Casanare;Orocué;12340;5376;6964
1064;85250;Casanare;Paz de Ariporo;36277;24933;11344
1065;85263;Casanare;Pore;11967;6822;5145
1066;85279;Casanare;Recetor;1634;312;1322
1067;85300;Casanare;Sabanalarga;3625;1781;1844
1068;85315;Casanare;Sácama;2090;1020;1070
1069;85325;Casanare;San Luis de Palenque;8466;3058;5408
1070;85400;Casanare;Támara;6873;1634;5239
1071;85410;Casanare;Tauramena;23527;14549;8978
1072;85430;Casanare;Trinidad;13233;6891;6342
1073;85440;Casanare;Villanueva;35305;26322;8983
1074;86001;Putumayo;Mocoa;56398;38457;17941
1075;86219;Putumayo;Colón;5407;3419;1988
1076;86320;Putumayo;Orito;37745;19833;17912
1077;86568;Putumayo;Puerto Asís;64867;38901;25966
1078;86569;Putumayo;Puerto Caicedo;16095;6089;10006
1079;86571;Putumayo;Puerto Guzmán;35390;4629;30761
1080;86573;Putumayo;Leguízamo;28468;12755;15713
1081;86749;Putumayo;Sibundoy;14940;10059;4881
1082;86755;Putumayo;San Francisco;5645;3385;2260
1083;86757;Putumayo;San Miguel;18780;4912;13868
1084;86760;Putumayo;Santiago;7290;3476;3814
1085;86865;Putumayo;Valle del Guamuez;33457;14882;18575
1086;86885;Putumayo;Villagarzón;23700;13742;9958
1087;88001;Archipiélago de San Andrés;San Andrés;55291;41400;13891
1088;88564;Archipiélago de San Andrés;Providencia;5989;3493;2496
1089;91001;Amazonas;Leticia;48144;33503;14641
1090;91263;Amazonas;El Encanto (ANM);2100;0;2100
1091;91405;Amazonas;La Chorrera (ANM);2967;0;2967
1092;91407;Amazonas;La Pedrera (ANM);3820;0;3820
1093;91430;Amazonas;La Victoria (ANM);644;0;644
1094;91460;Amazonas;Miriti - Paraná (ANM);1850;0;1850
1095;91530;Amazonas;Puerto Alegría (ANM);748;0;748
1096;91536;Amazonas;Puerto Arica (ANM);1013;0;1013
1097;91540;Amazonas;Puerto Nariño;9744;3544;6200
1098;91669;Amazonas;Puerto Santander (ANM);1758;0;1758
1099;91798;Amazonas;Tarapacá (ANM);3801;0;3801
1100;94001;Guainía;Inírida;31514;20279;11235
1101;94343;Guainía;Barranco Minas (ANM);8088;0;8088
1102;94663;Guainía;Mapiripana (ANM);1022;0;1022
1103;94883;Guainía;San Felipe (ANM);1667;0;1667
1104;94884;Guainía;Puerto Colombia (ANM);1874;0;1874
1105;94885;Guainía;La Guadalupe (ANM);279;0;279
1106;94886;Guainía;Cacahual (ANM);863;0;863
1107;94887;Guainía;Pana Pana (ANM);1899;0;1899
1108;94888;Guainía;Morichal (ANM);908;0;908
1109;95001;Guaviare;San José del Guaviare;52815;36354;16461
1110;95015;Guaviare;Calamar;9528;4339;5189
1111;95025;Guaviare;El Retorno;13653;3355;10298
1112;95200;Guaviare;Miraflores;6771;1943;4828
1113;97001;Vaupés;Mitú;29850;9746;20104
1114;97161;Vaupés;Caruru;2915;1387;1528
1115;97511;Vaupés;Pacoa (ANM);4042;0;4042
1116;97666;Vaupés;Taraira;2215;957;1258
1117;97777;Vaupés;Papunaua (ANM);727;0;727
1118;97889;Vaupés;Yavaraté (ANM);1048;0;1048
1119;99001;Vichada;Puerto Carreño;20936;14974;5962
1120;99524;Vichada;La Primavera;10122;5586;4536
1121;99624;Vichada;Santa Rosalía;4059;2383;1676
1122;99773;Vichada;Cumaribo;72691;2890;69801
;;;;;;
;;;;;;
